../../../data/verbs/verbs.voc

doručkovati | завтракать
doći | прийти
gledati | смотреть
govoriti | говорить
hodati | ходить
igrati | играть
ići | идти
jesti | есть
kazati | говорить
kopati | копать
kupovati | покупать
kuvati | готовить
ležati | лежать
misliti | думать
pevati | петь
pisati | писать
piti | пить
plivati | плавать
prati | стирать
pričati | разговаривать
prodavati | продавать
psovati | ругаться
putovati | путешествовать
raditi | делать
raditi | работать
razmišljati | думать
skakati | прыгать
slušati | слушать
spavati | спать
spremati | готовить
stajati | стоять
trčati | бежать
učiti | учить
voziti | водить
zvati | звать
čekati | ждать
čitati | читать
čuti | слышать
živeti | жить
svirati | играть
crtati | рисовать
šetati | гулять
slikati | фотографировать
trenirati | заниматься спортом
pitati | спрашивать
ručati | обедать
večerati | ужинать
odmarati | отдыхать
koristiti | использовать
praviti | делать
planirati | планировать
