../../../data/adjectives.voc

blizak | близкий
brz | быстрый
crn | чёрный
crven | красный
dalek | далекий
debeo | толстый
dobar | хороший
dosadan | скучный
drag | дорогой
dubok | глубокий
gorak | горький
grub | грубый
jak | сильный
kratak | короткий
lak | лёгкий
lep | красивый
# ljubak | милый
loš | плохой
mal | маленький
mek | мягкий
mlad | молодой
mlad | молодой
nov | новый
pametan | умный
redak | редкий
simpatičan | симпатичный
skup | дорогой
sladak | милый
sladak | сладкий
star | старый
suv | сухой
tanak | худой
težak | тяжёлый
tih | тихий
ukusan | вкусный
uzak | узкий
velik | большой
visok | высокий
zao | злой
čest | частый
čist | чистый
širok | широкий
