../../../vocabulary/nouns.voc

adresa | адрес
ananas | ананас
april | апрель
avgust | август
baba | бабушка
banana | банан
bluza | блузка
boranija | фасоль
borovnica | черника
brat | брат
breskva | персик
bundeva | тыква
celer | сельдерей
cvekla | свекла
dan | день
decembar | декабрь
deda | дедушка
dete | ребёнок
dinja | дыня
dud | шелковица
džemper | свитер
februar | февраль
film | фильм
grad | город
grašak | горошек
grejpfrut | грейпфрут
grožđe | виноград
haljina | платье
hotel | отель
jabuka | яблоко
jagoda | клубника
jaje | яйцо
jakna | куртка
januar | январь
jelovnik | меню
jesen | осень
jul | июль
jun | июнь
jutro | утро
kafa | кофе
kaiš | ремень
kajsija | абрикос
kapa | кепка
kaput | пальто
kivi | киви
kišobran | зонт
kofer | чемодан
kokos | кокос
kombinezon | комбинезон
košulja | рубашка
krastavac | огурец
kravata | галстук
krompir | картошка
kruška | груша
kukuruz | кукуруза
kupina | ежевика
kupus | капуста
kuća | дом
leto | лето
limun | лимон
lubenica | арбуз
maj | май
majica | футболка
majka | мама
malina | малина
mango | манго
mantil | плащ
marama | платок
mart | март
mačka | кошка
more | море
muzej | музей
nar | гранат
narandža | апельсин
nedelja | воскресение
novembar | ноябрь
novčanik | сумка
noć | ночь
odelo | костюм
odeća | одежда
oktobar | октябрь
otac | папа
pantalone | брюки
paradajz | помидор
pas | пёс
patlidžan | баклажан
petak | пятница
pečurka | гриб
pismo | письмо
pivo | пиво
plaža | пляж
ponedeljak | понедельник
pozorište | театр
proleće | весна
rad | работа
restoran | ресторан
rotkvica | редис
rukavica | перчатка
ruža | роза
salata | салат
sastanak | встреча
septembar | сентябрь
sestra | сестра
sestrić | племянник
sin | сын
smokva | инжир
soba | комната
sok | сок
spanać | шпинат
sreda | среда
stan | квартира
subota | суббота
suknja | юбка
suprug | муж
supruga | жена
tikvica | кабачок
trešnja | черешня
ulica | улица
unuk | внук
unuka | внучка
unučad | внуки
utorak | вторник
vino | вино
voda | вода
zima | зима
ćerka | дочь
čaj | чай
četvrtak | четверг
čizma | сапог
čovek | человек
šal | шарф
šargarepa | морковь
šešir | шляпа
šljiva | слива
šorc | шорты
žena | женщина
život | жизнь
